30
30
21 11 11 11 11 11 11 11 11 11 11 11 11 11 11 11 11 11 11 11 11 11 11 11 11 11 11 11 11 22
13 24 24 24 24 24 24 24 24 24 24 24 24 24 24 24 24 24 24 24 24 24 24 24 24 24 24 24 24 9
13 24 24 24 24 24 24 24 24 24 24 24 24 24 24 24 24 24 24 24 24 24 24 24 24 24 24 24 24 9
13 24 24 24 24 24 24 24 24 24 24 24 24 24 24 24 24 24 24 24 24 24 24 24 24 24 24 24 24 9
13 24 24 24 24 32 26 26 26 26 26 26 26 26 26 26 26 26 26 26 26 26 26 26 35 24 24 24 24 9
13 24 24 24 24 25 24 24 24 24 24 24 24 24 24 24 24 24 24 24 24 24 24 24 25 24 24 24 24 9
13 24 24 24 24 25 24 24 24 24 24 24 24 24 24 24 24 24 24 24 24 24 24 24 25 24 24 24 24 9
13 24 24 24 24 25 24 24 24 24 24 24 24 24 24 24 24 24 24 24 24 24 24 24 25 24 24 24 24 9
13 24 24 24 24 25 24 24 24 24 24 24 24 24 24 24 24 24 24 24 24 24 24 24 25 24 24 24 24 9
13 32 26 26 26 28 26 26 26 26 26 35 24 24 24 24 24 24 24 24 24 24 24 24 25 24 24 24 24 9
13 25 24 24 24 24 24 24 24 24 24 25 24 24 24 24 24 24 24 32 26 26 26 26 34 24 24 24 24 9
13 25 24 24 24 24 24 24 24 24 24 25 24 24 24 24 24 24 24 25 24 24 24 24 24 24 24 24 24 9
13 25 24 24 24 24 24 24 24 24 24 25 24 24 24 24 24 24 24 25 24 24 24 24 24 24 24 24 24 9
13 25 24 24 24 24 32 26 26 26 26 31 24 24 24 24 24 24 24 25 24 24 24 24 24 24 24 24 24 9
13 25 24 24 24 24 25 24 24 24 24 25 24 24 24 24 24 24 24 25 24 24 24 24 24 24 24 24 24 9
13 25 24 24 24 24 25 24 24 24 24 25 24 24 24 24 24 24 24 25 24 24 24 24 24 24 24 24 24 9
13 25 24 24 24 24 25 24 24 24 24 25 24 24 24 24 24 24 24 25 24 24 24 24 24 24 24 24 24 9
13 25 24 24 24 24 25 24 24 24 24 25 24 24 24 24 24 24 24 25 24 24 24 24 24 24 24 24 24 9
13 30 26 26 26 26 34 24 24 24 24 25 24 24 24 24 24 24 24 25 24 24 24 24 24 24 24 24 24 9
13 25 24 24 24 24 24 24 24 24 24 25 24 24 24 24 24 24 24 25 24 24 24 24 24 24 24 24 24 9
13 25 24 24 24 24 24 24 24 24 24 25 24 24 24 24 24 24 24 25 24 24 24 24 24 24 24 24 24 9
13 25 24 24 24 24 24 24 24 24 24 30 26 26 29 26 26 26 26 27 26 26 26 26 26 35 24 24 24 9
13 25 24 24 24 24 24 24 24 24 24 25 24 24 25 24 24 24 24 25 24 24 24 24 24 25 24 24 24 9
13 25 24 24 24 24 24 24 24 24 24 25 24 24 25 24 24 24 24 25 24 24 24 24 24 25 24 24 24 9
13 25 24 24 24 24 24 24 24 24 24 25 24 24 25 24 24 24 24 25 24 24 24 24 24 25 24 24 24 9
13 25 24 24 24 24 24 24 24 24 24 25 24 24 25 24 24 24 24 25 24 24 24 24 24 25 24 24 24 9
13 33 26 26 26 26 26 26 26 26 26 34 24 24 25 24 24 24 24 25 24 24 24 24 24 25 24 24 24 9
13 24 24 24 24 24 24 24 24 24 24 24 24 24 33 26 26 26 26 28 26 26 26 26 26 34 24 24 24 9
13 24 24 24 24 24 24 24 24 24 24 24 24 24 24 24 24 24 24 24 24 24 24 24 24 24 24 24 24 9
17 15 15 15 15 15 15 15 15 15 15 15 15 15 15 15 15 15 15 15 15 15 15 15 15 15 15 15 15 19